111111111111100111111111111111
100000000000000000000000000001
100000000000000000000000000001
100111111111000011111111111001
100000000000000000000000000001
100000000000000000000000000001
100111111110011001111111111001
100100000000000000000000001001
100100000000000000000000001001
100100100111111111001001001001
100000100100000000001001000001
100000100100000000001001000001
100100100100110011001001001001
111100100100100001001001001111
000000000100105001001000000000
000000000100100001001000000000
111100100100100001001001001111
100100100100111111001001001001
100000100100000000001001000001
100100100100111111111001001001
100100000000000000000000001001
100100000000000000000000001001
100111111110011001111111111001
100000000000000000000000000001
100000000000000000000000000001
100111111111000011111111111001
100000000000000000000000000001
100000000000000000000000000001
111111111111100111111111111111