111111111111111111111111111111
1F0F4F0F0F0F0F0F0F0F0F0F0F0F01
100000000000000000000000000001
100111111111000011111111111001
1F0F0F0F0F0F0F0F0F0F0F0F0F0F01
100000000000000000000000000001
1F0111111110011001111111111F01
1001F0F0F0F0F0F0F0F0F0F0F01001
1F01000F0000000000000F00001F01
1001F0100111111111F01001F01001
1F0F001F01F0F0F0F0001F010F0F01
1000F01001F0000000F01001F00001
1001001F0100110011001F01001001
1111F01001F0150001F01001F01111
1F0F0F0F0100100001001F0F0F0F01
1000F00001F0100001F01000F00001
1111001F0100100001001F01001111
1001F01001F0111111F01001F01001
1F0F001F010F0F0F0F001F010F0F01
1000F01001F0000000001001F00001
1F01001F0100111111111F01001F01
1001F0F0F0F0F0F0F0F0F0F0F01001
1F0100000000000000000000001F01
100111111110011001111111111001
1F0F0F0F0F0F0F0F0F0F0F0F0F0F01
100000000000000000000000000001
100111111111000011111111111001
1F0F0F0F0F0F0F0F0F0F0F0F0F0F01
100000000000000000000000000001
111111111111111111111111111111