111111111111100111111111111111
150F0F0F0F0F0F0F0F0F0F0F0F0F01
100000000000000000000000000001
1F0111111111000011111111111001
100F0F0F0F0F0F0F0F0F0F0F0F0F01
1F0000000000000000000000000001
100111111110011001111111111001
1F01F0000000000000000000001001
100100000000000000000000001001
1F01F0100111111111001001001001
100000100100000000001001000001
1F00F0100100000000001001000001
100100100100110011001001001001
1111F0100100100001001001001111
000000000100100001001000000000
0000F0000100100001001000000000
111100100100100001001001001111
100100100100111111001001001001
100000100100000000001001000001
100000100100000000001001000001
100100100100111111111001001001
100100000000000000000000001001
100100000000000000000000001001
100111111110011001111111111001
100000000000000000000000000001
100000000000000000000000000001
100111111111000011111111111001
100000000000000000000000000001
100000000000000000000000000001
111111111111100111111111111111