111111111111100111111111111111
1F0F4F0F0F0F0F0F0F0F0F0F0F0F01
100000000000000000000000000001
100111111111000011111111111001
1F0F0F0F0F0F0F0F0F0F0F0F0F0F01
100000000000000000000000000001
1F0111111110011001111111111F01
1001F0F0F0F0F0F0F0F0F0F0F01001
1F0100000000000000000000001F01
1001F0100111111111F01001F01001
1F0F001F01F0F0F0F0F01F010F0F01
1000F010F100000000001001F00001
1001001F0100110011001F01001001
1111F010F1F0150001F01001F01111
0F0F0F0F010F1000010F1F0F0F0F00
0000000001F0100001F01000000000
1111001F010F1000010F1F010F1111
10F1F010F1F0111111F010F1F010F1
1F0F001F010F0F0F0F0F1F010F0F01
10F0F010F1F0F0F0F0F010F1F0F0F1
1F01001F010F111111111F010F1F01
10F1F0F0F0F0F0F0F0F0F0F0F010F1
1F010F0F0F0F0F0F0F0F0F0F0F1F01
10F111111110F110F11111111110F1
1F0F0F0F0F0F0F0F0F0F0F0F0F0F01
10F0F0F0F0F0F0F0F0F0F0F0F0F0F1
1F01111111110F0F11111111111F01
10F0F0F0F0F0F0F0F0F0F0F0F0F0F1
1F0F0F0F0F0F0F0F0F0F0F0F0F0F01
111111111111100111111111111111